NO ./path_to_the_north_texture
SO ./path_to_the_south_texture
WE ./path_to_the_west_texture
EA ./path_to_the_east_texture

F 220,100,55
C 225,30,100


        1111111111111111111111111
        1000000000110010000000001
        1011000001110000000000001
        1001000000000000000000001
111111111011000001110000000000001
100000000011000001110111111111111
111101111111110111000000100011111
11110111111111011101010010001
11000000110101011000000100011
10001000000000011000000010001
100000000000000110101000100111
1100000111010101111N1011000111
11110111 1110101 1011100100001
11111111 1111111 111111111111