NO ./texture/north_texture.xpm
SO ./texture/south_texture.xpm
WE ./texture/west_texture.xpm
EA ./texture/east_texture.xpm

F 220,100,0
C 225,1,2

              1111111111
              1000N00001
              1001111011
              1000001001
              1000001101
              1000001001
              1000111011
              1000100001
        1111111111101111111111111
        1000000000001000000000001
        1011000001111001000000001
        1001000000000000000000001
111111111011000001110000000000001
100000000011000001110111111111111                             11111111111
11110111111111011100000010001                                 10000000001
11110111111111011101010010001                                 10000000001
11000000110101011100000010001                                 10000000000111111
1000000000000000110000001000111111111111111111111111111111111110000000000000001
1000000000000000110101001000000000000000000000000000000000000000000000000000001
1100000111010101111101111000111111111111111111111111111111111111111111110000001
10100111 1110101 101111010001                                          10000001
10001111 1111111 111111111111                                          11111111
11011
10001
10001
10001
11111