NO ./texture/north_texture.xpm                         
SO ./texture/south_texture.xpm
WE ./texture/west_texture.xpm
EA ./texture/east_texture.xpm

F 86,125,70
C 135,206,255

                  111
              1111000111
              1000000001
              1001111011
              1000001001
              1000001101
              1000001001
              1000111011
              1000100001
        1111111111100111111111111
        1000000000011000000000001
        1011000001111001000000001
        1001000000200000000000001
111111111111000001110000000000001
100000000011000001111111111111111                             11111111111
11110111111111000000000010001                                 10000000001
11110111111111011101010010001                                 10000000001
11000000110101011100000010001                                 10000000001111111
1000000000000000110000001111111111111111111111111111111111111110000000000000001
1000000000000000110001000000000000000000000000000000000000000000000000000000001
10S0000111010101111111111111111111111111111111111111111111111111111111110000001
10000111 1111111 111111111111                                          10000001
11211111 1111111 111111111111                                          11111111
10001
10001
11111