NO ./texture/north_texture.xpm
SO ./texture/south_texture.xpm
WE ./texture/west_texture.xpm
EA ./texture/east_texture.xpm

F 220,100,55
C 220,5,89

        1111111111111111111111111
        1000000000110000000000001
        1011000001110000000000001
        1001000000000000000000001
111111111011000001110000000000001
10000000001100000111011111111111
11110111111111011100000010001
11110111111111011100010010001
11000000110101011100000010001
10000000000N00000111000001001
10000000000000001101010010001
110000011101010111110111100111111
11110111 1110101 101111010001
11111111 1111111 111111111111