NO ./texture/north_texture.xpm
SO ./texture/south_texture.xpm
WE ./texture/west_texture.xpm
EA ./texture/east_texture.xpm

F 220,100,0
C 225,1,2

        1111111111111111111111111
        1000000000110000000000001
        1011000001110000000000001
        1001000000000000000000001
111111111011000001110000000000001
100000000011000001110111111111111
11110111111111011100000010001
11110111111111011101010010001
110000001101010111000000N0001
10000000000000001100000010001
11000000000000000110101010011
10000011101010111101100011001
11110111 1110101 101111010001
11111111 1111111 111111111111